{10, 10, 10, 10, 10, 10, 10, 10, 10, 10, 10, 10, 10, 10, 10},
{10, 32, 00, 00, 00, 00, 10, 00, 00, 12, 00, 00, 00, 21, 10},
{10, 00, 10, 00, 30, 00, 10, 31, 10, 10, 10, 10, 10, 10, 10},
{10, 55, 10, 31, 00, 56, 10, 00, 00, 00, 00, 54, 00, 32, 10},
{10, 00, 10, 10, 10, 10, 10, 51, 10, 10, 00, 10, 00, 00, 10},
{10, 00, 12, 00, 00, 53, 00, 00, 00, 00, 31, 10, 00, 31, 10},
{10, 10, 10, 10, 10, 10, 10, 00, 10, 10, 10, 10, 10, 10, 10},
{10, 10, 32, 00, 10, 10, 10, 00, 10, 00, 00, 12, 00, 30, 10},
{10, 10, 30, 00, 00, 50, 00, 00, 00, 52, 10, 10, 00, 10, 10},
{10, 10, 31, 00, 10, 10, 10, 00, 10, 10, 10, 10, 00, 10, 10},
{10, 10, 10, 10, 10, 10, 10, 00, 10, 10, 31, 10, 00, 31, 10},
{10, 31, 31, 32, 10, 10, 00, 00, 00, 10, 31, 10, 00, 00, 10},
{10, 30, 00, 00, 11, 11, 00, 00, 00, 10, 31, 10, 00, 00, 10},
{10, 31, 31, 32, 10, 10, 00, 20, 00, 10, 00, 11, 54, 31, 10},
{10, 10, 10, 10, 10, 10, 10, 10, 10, 10, 10, 10, 10, 10, 10},

